NO assets/wall_omar_fred_NORTH.xpm
SO assets/wall_omar_fred_SOUTH.xpm
WE assets/wall_omar_fred_WEST.xpm
EA assets/wall_omar_fred_EAST.xpm

F 164,169,20
C 153,204,255

111111111111111111111
10100000D00000000000011111
10101010101D11111000000001
10001010001000001000000001
11111010111110101110111111
100000101000101000001
101111101011101111111
101000X01010D00000101
101011111010111110101
101010001010100010101
101110101010101010101
100000101010001010001
111111101011111011101
100X00101000100010001
101110101110101110111
101000100000100010101
101011111111111010101
10000000OOO0000010001
1D11011110111O1D11101
1N0D00000000000000001
111111111111111111111