NO assets/wall_omar_fred_NORTH.xpm
SO assets/wall_omar_fred_SOUTH.xpm
WE assets/wall_omar_fred_WEST.xpm
EA assets/wall_omar_fred_EAST.xpm

F 164,169,20
C 153,204,255

111111111111111111111
100000000000000000001
100000000000000100001
100000000000000100001
100000000000000111111
1000000000000000000N1
111111111111111111111